FPA_time,MAV_time,Check,FPA_total_points,MAV_total_points,FPA_total_nodes,MAV_total_nodes
284,793,1,5,5,10,392
233,796,1,4,4,8,374
159,799,1,4,4,8,386
83,665,1,3,3,6,344
446,951,1,5,5,10,466
389,1557,1,7,7,14,740
538,1078,1,8,8,16,522
325,809,1,5,5,10,404
124,532,1,3,3,6,256
971,821,1,9,9,18,406
