FPA_time,MAV_time,Check,FPA_total_points,MAV_total_points,FPA_total_nodes,MAV_total_nodes
100,915,1,3,3,6,420
655,1020,1,8,8,16,500
723,845,1,6,6,12,394
119,987,1,4,4,8,376
139,890,1,5,5,10,408
250,1098,1,3,3,6,512
189,719,1,4,4,8,352
271,648,1,5,5,10,300
24,742,1,1,1,2,352
251,797,1,4,4,8,396
