FPA_time,MAV_time,Check,FPA_total_points,MAV_total_points,FPA_total_nodes,MAV_total_nodes
845,787,1,8,8,16,380
194,1113,1,4,4,8,542
286,953,1,5,5,10,478
601,747,1,6,6,12,364
268,949,1,3,3,6,456
64,752,1,3,3,6,362
591,799,1,7,7,14,380
48,608,1,2,2,4,292
288,1266,1,5,5,10,606
94,438,1,2,2,4,198
